

        ┏━━━━━━━━━━━━━━━━━━━━━━━━━━━━━━━━━━━━━━━━━━━━━━━━━━━━━━━━━━━━━━┓
        ┃                                                              ┃
        ┃   Link your key                                              ┃
        ┃   Choose how the dashboard can look up your public key.      ┃
        ┃                                                              ┃
        ┃   ▊▔▔▔▔▔▔▔▔▔▔▔▔▔▔▔▔▔▔▔▔▔▔▔▔▔▔▔▔▔▔▔▔▔▔▔▔▔▔▔▔▔▔▔▔▔▔▔▔▔▔▔▔▔▔▎   ┃
        ┃   ▊ ▐●▌ Link via GitHub (gh)                             ▎   ┃
        ┃   ▊ ▐●▌ Show me the key; I'll add it myself              ▎   ┃
        ┃   ▊▁▁▁▁▁▁▁▁▁▁▁▁▁▁▁▁▁▁▁▁▁▁▁▁▁▁▁▁▁▁▁▁▁▁▁▁▁▁▁▁▁▁▁▁▁▁▁▁▁▁▁▁▁▁▎   ┃
        ┃                                                              ┃
        ┃   ╭──────────────────────────────────────────────────────╮   ┃
        ┃   │ ssh-ed25519                                          │   ┃
        ┃   │ AAAAC3NzaC1lZDI1NTE5AAAAIJqumyDZyUiiUu9rtELKJeDd45n4 │   ┃
        ┃   │ 6oMG2928j2vUqa3o cc-sentiment                        │   ┃
        ┃   ╰──────────────────────────────────────────────────────╯   ┃
        ┃                                                              ┃
        ┃                                                              ┃
        ┃                                                              ┃
        ┃                         ▔▔▔▔▔▔▔▔▔▔▔▔▔▔▔▔ ▔▔▔▔▔▔▔▔▔▔▔▔▔▔▔▔    ┃
        ┃                                                              ┃
        ┗━━━━━━━━━━━━━━━━━━━━━━━━━━━━━━━━━━━━━━━━━━━━━━━━━━━━━━━━━━━━━━┛
